#####################
#S#           #     #
# ####### ### ### # #
#   #     #   #   # #
### # ####### # ### #
# # #       #   # # #
# # # ##### ##### # #
#   #     #     # # #
# ############# # # #
#             # #   #
############# # #####
#         #   #     #
# ##### ### ### ### #
# #   #   #   # #   #
# # # ### ### ### ###
#   # # #   #   #   #
##### # ### ### ### #
#   # #   #     #   #
# # # ### ####### # #
# #               #E#
#####################
